111111111111
100000000001
10000P000101
1000E0000C11
111111111111