111111111111111111111
1000000E0000C010C0101
100000000110101010101
1P00000000C010C010C01
111111111111111111111