111111111111
1000000E0001
100000000111
1P00000000C1
111111111111