111111111111
1C0000000001
10000P000101
1000E0000011
111111111111