1111111111111
1C1C1C1C1C101
1010101010101
1010101010101
1010101010101
10P00000000E1
1111111111111
